10 10
0 0
000 000 002 000 000 000 000 000 012 014
000 000 000 000 000 000 000 000 013 012
000 000 000 000 000 000 000 000 000 000
000 000 000 000 000 000 000 000 000 000
000 000 000 000 000 000 000 000 000 000
000 000 000 000 000 000 000 000 000 000
000 000 000 000 000 000 000 000 000 000
000 000 000 000 000 000 000 001 000 000
000 000 000 000 003 004 000 000 010 011
000 000 000 000 000 000 000 000 010 010

999 999 999 999 999 999 999 999 999 999
999 999 999 999 999 999 999 999 999 999
999 015 016 999 999 999 999 999 999 999
999 017 018 999 999 999 999 999 999 999
999 999 999 999 999 999 999 999 999 999
999 999 999 999 999 999 999 999 999 999
999 999 999 999 999 999 999 999 999 999
999 999 999 999 999 999 999 999 999 999
999 999 999 999 999 999 999 999 999 999
999 999 999 999 999 999 999 999 999 999

999 999 999 999 999 999 999 999 999 999
999 999 999 999 999 999 999 999 999 999
999 999 999 031 032 999 999 999 999 999
999 999 999 033 034 999 999 999 999 999
999 019 020 999 999 999 999 999 999 999
999 021 022 999 999 999 999 999 999 999
999 999 999 999 999 999 999 999 999 999
999 999 999 999 999 999 999 999 999 999
999 999 999 999 999 999 999 999 999 999
999 999 999 999 999 999 999 999 999 999

999 999 999 999 999 999 999 999 999 999
999 999 999 999 999 999 999 999 999 999
999 999 999 999 999 035 036 037 038 999
999 999 999 999 999 039 040 041 042 999
999 999 999 999 999 043 044 045 046 999
999 999 999 999 999 047 048 049 050 999
999 023 024 999 999 999 999 999 999 999
999 025 026 999 999 999 999 999 999 999
999 999 999 999 999 999 999 999 999 999
999 999 999 999 999 999 999 999 999 999

