10 10
0 0
000 000 000 000 000 000 000 000 000 000
000 000 000 000 000 000 000 000 000 000
000 000 2040 2041 000 000 000 000 000 000
000 000 2168 2169 000 000 000 000 000 000
000 000 4022 4023 000 000 000 000 000 000
000 000 000 000 000 000 000 000 000 000
000 000 000 000 000 000 000 000 000 000
000 000 000 000 000 000 000 000 000 000
000 000 000 000 000 000 000 000 000 000
000 000 000 000 000 000 000 000 000 000

999 999 999 999 999 999 999 999 999 999
999 999 999 999 999 999 999 999 999 999
999 999 999 999 999 999 999 999 999 999
999 999 999 999 999 999 999 999 999 999
999 999 999 999 999 999 999 999 999 999
999 999 999 999 999 999 999 999 999 999
999 999 999 999 999 999 999 999 999 999
999 999 999 999 999 999 999 999 999 999
999 999 999 999 999 999 999 999 999 999
999 999 999 999 999 999 999 999 999 999

999 999 999 999 999 999 999 999 999 999
999 999 999 999 999 999 999 999 999 999
999 999 999 999 999 999 999 999 999 999
999 999 999 999 999 999 999 999 999 999
999 999 999 999 999 999 999 999 999 999
999 999 999 999 999 999 999 999 999 999
999 999 999 999 999 999 999 999 999 999
999 999 999 999 999 999 999 999 999 999
999 999 999 999 999 999 999 999 999 999
999 999 999 999 999 999 999 999 999 999

999 999 999 999 999 999 999 999 999 999
999 999 999 999 999 999 999 999 999 999
999 999 999 999 999 999 999 999 999 999
999 999 999 999 999 999 999 999 999 999
999 999 999 999 999 999 999 999 999 999
999 999 999 999 999 999 999 999 999 999
999 999 999 999 999 999 999 999 999 999
999 999 999 999 999 999 999 999 999 999
999 999 999 999 999 999 999 999 999 999
999 999 999 999 999 999 999 999 999 999

