10 10
0 0
000 000 020 000 000 000 000 000 000 000
000 000 000 000 000 000 000 000 000 000
000 000 000 000 000 000 000 000 000 000
000 000 000 000 000 000 000 000 000 000
000 000 000 000 000 000 000 000 000 000
000 000 000 000 000 000 000 000 000 000
000 000 000 000 000 000 000 000 000 000
000 000 000 000 000 000 000 000 000 000
000 000 000 000 000 000 000 000 000 000
000 000 000 000 000 000 000 000 000 000
 
999 999 999 999 999 999 999 999 999 999
999 999 999 999 999 999 999 999 999 999
999 999 999 999 999 999 999 999 999 999
999 999 999 999 999 999 999 999 999 999
999 999 999 999 999 999 999 999 999 999
999 999 999 999 999 999 999 999 999 999
999 999 999 999 999 999 999 999 999 999
999 999 999 999 999 999 999 999 999 999
999 999 999 999 999 999 999 999 999 999
999 999 999 999 999 999 999 999 999 999
 
999 999 999 999 999 999 999 999 999 999
999 999 999 999 999 999 999 999 999 999
999 999 999 999 999 999 999 999 999 999
999 999 999 999 999 999 999 999 999 999
999 999 999 999 999 999 999 999 999 999
999 999 999 999 999 999 999 999 999 999
999 999 999 999 999 999 999 999 999 999
999 999 999 999 999 999 999 999 999 999
999 999 999 999 999 999 999 999 999 999
999 999 999 999 999 999 999 999 999 999
 
999 999 999 999 999 999 999 999 999 999
999 999 999 999 999 999 999 999 999 999
999 999 999 999 999 999 999 999 999 999
999 999 999 999 999 999 999 999 999 999
999 999 999 999 999 999 999 999 999 999
999 999 999 999 999 999 999 999 999 999
999 999 999 999 999 999 999 999 999 999
999 999 999 999 999 999 999 999 999 999
999 999 999 999 999 999 999 999 999 999
999 999 999 999 999 999 999 999 999 999